Rk,Player,Pos,Age,Tm,G,GS,MP,FG,FGA,3P,3PA,2P,2PA,FT,FTA,ORB,DRB,TRB,AST,STL,BLK,TOV,PF,PTS
1,Quincy Acy,PF,25,SAC,59,29,876,119,214,19,49,100,165,50,68,65,123,188,27,29,24,27,103,307
2,Jordan Adams,SG,21,MEM,2,0,15,2,6,0,1,2,5,3,5,0,2,2,3,3,0,2,2,7
3,Steven Adams,C,22,OKC,80,80,2014,261,426,0,0,261,426,114,196,219,314,533,62,42,89,84,223,636
4,Arron Afflalo,SG,30,NYK,71,57,2371,354,799,91,238,263,561,110,131,23,243,266,144,25,10,82,142,909
5,Alexis Ajinca,C,27,NOP,59,17,861,150,315,0,1,150,314,52,62,75,194,269,31,19,36,54,134,352
6,Cole Aldrich,C,27,LAC,60,5,800,134,225,0,0,134,225,60,84,86,202,288,50,47,68,64,139,328
7,LaMarcus Aldridge,PF,30,SAS,74,74,2261,536,1045,0,16,536,1029,259,302,176,456,632,110,38,81,99,151,1331
8,Cliff Alexander,PF,20,POR,8,0,36,5,10,0,0,5,10,0,0,2,4,6,0,1,2,1,1,10
9,Lavoy Allen,PF,26,IND,79,28,1599,191,370,0,0,191,370,46,73,162,262,424,76,26,42,69,147,428
10,Tony Allen,SG,34,MEM,64,57,1620,215,469,15,42,200,427,90,138,104,192,296,70,110,18,78,175,535
11,Al-Farouq Aminu,SF,25,POR,82,82,2341,299,719,126,349,173,370,115,156,98,401,499,138,72,53,120,171,839
12,Lou Amundson,PF,33,NYK,29,0,204,19,53,0,0,19,53,14,27,23,26,49,12,6,7,15,44,52
13,Chris Andersen,C,37,TOT,27,15,402,38,72,4,14,34,58,25,36,36,62,98,12,15,13,9,29,105
13,Chris Andersen,C,37,MIA,7,1,36,4,10,2,5,2,5,3,4,3,6,9,3,1,3,2,4,13
13,Chris Andersen,C,37,MEM,20,14,366,34,62,2,9,32,53,22,32,33,56,89,9,14,10,7,25,92
14,Alan Anderson,SG,33,WAS,13,0,192,21,59,12,37,9,22,11,15,1,26,27,14,4,1,2,25,65
15,James Anderson,SG,26,SAC,51,15,721,67,178,23,86,44,92,22,29,13,73,86,41,21,14,42,54,179
16,Justin Anderson,SF,22,DAL,55,9,647,71,175,22,83,49,92,44,55,18,114,132,29,19,25,24,45,208
17,Kyle Anderson,SF,22,SAS,78,11,1245,138,295,12,37,126,258,62,83,25,219,244,123,60,29,59,97,350
18,Ryan Anderson,PF,27,NOP,66,7,2008,397,929,131,358,266,571,199,228,131,265,396,73,38,25,90,109,1124
19,Giannis Antetokounmpo,PG,21,MIL,80,79,2823,513,1013,28,109,485,904,296,409,113,499,612,345,94,113,208,258,1350
20,Thanasis Antetokounmpo,SF,23,NYK,2,0,6,3,4,0,1,3,3,0,0,0,1,1,0,0,0,0,2,6
21,Carmelo Anthony,SF,31,NYK,72,72,2530,567,1307,105,310,462,997,334,403,98,458,556,299,62,38,176,180,1573
22,Joel Anthony,C,33,DET,19,0,96,6,10,0,0,6,10,6,8,8,13,21,1,2,12,2,15,18
23,Keith Appling,PG,23,ORL,5,0,27,2,8,0,3,2,5,2,2,0,1,1,1,1,0,3,5,6
24,Trevor Ariza,SF,30,HOU,81,81,2859,357,859,185,499,172,360,126,161,67,299,366,188,160,26,113,177,1025
25,Darrell Arthur,PF,27,DEN,70,16,1516,221,489,45,117,176,372,40,53,86,207,293,96,53,48,66,185,527
26,Omer Asik,C,29,NOP,68,64,1178,104,195,0,0,104,195,61,112,120,294,414,26,21,23,60,124,269
27,D.J. Augustin,PG,28,TOT,62,0,1178,148,350,68,168,80,182,103,128,8,87,95,198,38,4,84,85,467
27,D.J. Augustin,PG,28,OKC,34,0,519,46,121,24,61,22,60,26,34,5,38,43,66,13,2,30,41,142
27,D.J. Augustin,PG,28,DEN,28,0,659,102,229,44,107,58,122,77,94,3,49,52,132,25,2,54,44,325
28,Jeff Ayres,C,28,LAC,17,0,107,12,23,0,1,12,22,6,6,4,18,22,5,0,3,6,18,30
29,Luke Babbitt,SF,26,NOP,47,13,845,122,289,44,109,78,180,39,50,25,123,148,53,11,7,23,90,327
30,Cameron Bairstow,C,25,CHI,18,2,103,13,40,1,5,12,35,7,8,4,24,28,6,2,3,4,19,34
31,Leandro Barbosa,SG,33,GSW,68,0,1079,171,370,39,110,132,260,52,62,28,89,117,82,44,10,53,107,433
32,J.J. Barea,PG,31,DAL,74,16,1667,317,711,100,260,217,451,74,96,26,126,152,302,26,2,113,110,808
33,Andrea Bargnani,C,30,BRK,46,0,634,127,279,3,16,124,263,47,57,28,69,97,18,4,9,26,61,304
34,Harrison Barnes,SF,23,GSW,66,59,2042,295,633,82,214,213,419,102,134,77,248,325,117,41,10,57,136,774
35,Matt Barnes,SF,35,MEM,76,45,2190,264,693,119,370,145,323,111,138,84,336,420,163,78,57,121,234,758
36,Will Barton,SG,25,DEN,82,1,2353,425,983,112,325,313,658,216,268,59,417,476,203,71,39,139,147,1178
37,Brandon Bass,PF,30,LAL,66,0,1342,174,317,0,2,174,315,125,148,104,181,285,74,33,55,42,125,473
38,Nicolas Batum,SF,27,CHO,70,70,2448,372,873,139,399,233,474,163,192,55,373,428,403,65,43,205,114,1046
39,Jerryd Bayless,SG,27,MIL,52,18,1505,185,437,101,231,84,206,70,90,21,120,141,163,47,11,73,111,541
40,Aron Baynes,C,29,DET,81,1,1233,194,384,0,2,194,382,126,165,140,244,384,51,21,52,67,151,514
41,Kent Bazemore,SF,26,ATL,75,68,2083,320,725,109,305,211,420,123,151,28,351,379,171,98,38,138,176,872
42,Bradley Beal,SG,22,WAS,55,35,1708,359,799,105,271,254,528,135,176,41,147,188,162,54,11,112,117,958
43,Michael Beasley,PF,27,HOU,20,0,363,107,205,3,9,104,196,38,49,29,69,98,16,11,9,24,39,255
44,Marco Belinelli,SG,29,SAC,68,7,1672,245,635,91,297,154,338,115,138,10,107,117,127,37,2,80,91,696
45,Anthony Bennett,PF,22,TOR,19,0,84,8,27,3,14,5,13,9,10,6,17,23,0,5,0,4,8,28
46,Patrick Beverley,PG,27,HOU,71,63,2041,258,594,124,310,134,284,60,88,73,177,250,239,94,26,91,234,700
47,Bismack Biyombo,C,23,TOR,82,22,1808,156,288,0,1,156,287,142,226,182,473,655,29,19,133,71,225,454
48,Nemanja Bjelica,PF,27,MIN,60,0,1075,110,235,48,125,62,110,40,55,49,161,210,83,26,21,47,154,308
49,Tarik Black,C,24,LAL,39,0,496,57,104,0,0,57,104,19,45,44,113,157,16,14,18,22,78,133
50,DeJuan Blair,C,26,WAS,29,0,218,28,68,0,1,28,67,5,13,20,37,57,11,8,2,15,53,61
51,Steve Blake,PG,35,DET,58,2,986,93,240,52,151,41,89,16,20,9,80,89,200,24,5,81,70,254
52,Eric Bledsoe,PG,26,PHO,31,31,1059,223,492,48,129,175,363,138,172,18,107,125,190,63,19,110,75,632
53,Bojan Bogdanovic,SF,26,BRK,79,39,2115,324,749,129,338,195,411,110,132,36,219,255,99,29,5,115,119,887
54,Andrew Bogut,C,31,GSW,70,66,1451,175,279,1,1,174,278,24,50,121,371,492,162,33,114,83,221,375
55,Matt Bonner,C,35,SAS,30,2,206,29,57,15,34,14,23,3,4,3,24,27,9,6,1,3,16,76
56,Devin Booker,SG,19,PHO,76,51,2108,367,867,99,289,268,578,215,256,27,160,187,200,44,20,160,225,1048
57,Trevor Booker,PF,28,UTA,79,2,1632,190,388,12,41,178,347,71,106,166,286,452,84,59,41,81,169,463
58,Chris Bosh,PF,31,MIA,53,53,1778,358,767,81,222,277,545,213,268,48,342,390,128,36,34,78,101,1010
59,Avery Bradley,SG,25,BOS,76,72,2536,456,1019,147,407,309,612,96,123,48,172,220,158,117,19,109,164,1155
60,Elton Brand,C,36,PHI,17,1,225,31,72,0,1,31,71,8,9,9,54,63,18,9,8,11,32,70
61,Corey Brewer,SF,29,HOU,82,12,1669,212,552,61,224,151,328,105,140,42,157,199,109,84,19,78,168,590
62,Aaron Brooks,PG,31,CHI,69,0,1108,188,469,66,185,122,284,49,64,21,80,101,180,30,10,82,132,491
63,Anthony Brown,SF,23,LAL,29,11,599,39,126,20,70,19,56,17,20,9,61,70,19,14,5,15,34,115
64,Lorenzo Brown,PG,25,PHO,8,0,61,8,25,1,8,7,17,3,4,0,7,7,11,3,1,9,4,20
65,Markel Brown,SG,24,BRK,62,6,982,127,322,38,121,89,201,71,94,23,99,122,91,38,15,54,94,363
66,Kobe Bryant,SF,37,LAL,66,66,1863,398,1113,133,467,265,646,232,281,41,206,247,184,62,13,129,115,1161
67,Chase Budinger,SF,27,TOT,66,2,929,104,239,24,86,80,153,39,56,43,107,150,64,32,10,44,62,271
67,Chase Budinger,SF,27,IND,49,2,729,81,194,20,69,61,125,34,48,31,90,121,49,29,9,31,46,216
67,Chase Budinger,SF,27,PHO,17,0,200,23,45,4,17,19,28,5,8,12,17,29,15,3,1,13,16,55
68,Reggie Bullock,SF,24,DET,37,0,429,43,98,22,53,21,45,14,15,14,54,68,27,10,2,8,29,122
69,Trey Burke,PG,23,UTA,64,0,1366,262,634,88,256,174,378,67,82,18,94,112,148,35,6,80,86,679
70,Alec Burks,SG,24,UTA,31,3,797,137,334,32,79,105,255,106,141,16,93,109,63,18,4,51,71,412
71,Caron Butler,SF,35,SAC,17,1,176,25,59,3,18,22,41,10,12,5,17,22,10,9,1,3,19,63
72,Jimmy Butler,SG,26,CHI,67,67,2474,470,1035,64,205,406,830,395,475,79,279,358,321,110,43,132,124,1399
73,Rasual Butler,SF,36,SAS,46,0,432,49,104,15,49,34,55,11,16,3,53,56,24,13,23,8,11,124
74,Bruno Caboclo,SF,20,TOR,6,1,43,1,12,1,7,0,5,0,0,1,1,2,1,2,1,4,2,3
75,Jose Calderon,PG,34,NYK,72,72,2024,209,455,84,203,125,252,42,48,22,207,229,298,63,7,87,135,544
76,Kentavious Caldwell-Pope,SG,22,DET,76,76,2789,403,960,114,369,289,591,185,228,70,212,282,138,110,17,105,167,1105
77,Isaiah Canaan,SG,24,PHI,77,39,1966,260,722,176,485,84,237,150,180,20,154,174,137,56,12,91,133,846
78,Clint Capela,C,21,HOU,77,35,1471,231,397,0,1,231,396,80,211,194,300,494,47,59,92,60,190,542
79,DeMarre Carroll,SF,29,TOR,26,22,786,105,270,46,118,59,152,30,50,31,91,122,27,44,6,28,63,286
80,Vince Carter,SG,39,MEM,60,3,1005,133,343,59,169,74,174,70,84,31,115,146,56,38,16,35,101,395
81,Michael Carter-Williams,PG,24,MIL,54,37,1649,251,555,15,55,236,500,106,162,48,228,276,281,80,41,153,162,623
82,Omri Casspi,PF,27,SAC,69,21,1880,299,622,112,274,187,348,103,159,58,352,410,95,56,17,94,154,813
83,Willie Cauley-Stein,C,22,SAC,66,39,1412,191,339,0,2,191,337,81,125,134,218,352,37,48,66,46,146,463
84,Mario Chalmers,PG,29,TOT,61,7,1373,182,444,46,149,136,295,218,262,24,133,157,230,88,13,110,181,628
84,Mario Chalmers,PG,29,MIA,6,0,120,10,32,1,11,9,21,12,13,1,13,14,19,8,1,9,16,33
84,Mario Chalmers,PG,29,MEM,55,7,1253,172,412,45,138,127,274,206,249,23,120,143,211,80,12,101,165,595
85,Tyson Chandler,C,33,PHO,66,60,1618,183,314,0,1,183,313,106,171,175,401,576,64,36,44,93,145,472
86,Rakeem Christmas,PF,24,IND,1,0,6,2,2,0,0,2,2,0,0,1,0,1,0,0,0,0,1,4
87,Ian Clark,SG,24,GSW,66,1,578,89,202,30,84,59,118,28,34,13,55,68,64,17,13,43,58,236
88,Coty Clarke,SF,23,BOS,3,0,6,2,4,2,2,0,2,0,0,0,1,1,0,0,0,1,0,6
89,Jordan Clarkson,SG,23,LAL,79,79,2552,475,1098,111,320,364,778,164,204,93,220,313,192,88,7,135,168,1225
90,Norris Cole,PG,27,NOP,45,23,1198,196,484,33,102,163,382,52,65,10,141,151,167,37,5,75,102,477
91,Darren Collison,PG,28,SAC,74,15,2219,377,776,87,217,290,559,194,226,28,141,169,318,76,4,130,142,1035
92,Nick Collison,PF,35,OKC,59,4,699,50,109,0,2,50,107,23,33,68,103,171,52,15,16,50,107,123
93,Mike Conley,PG,28,MEM,56,56,1761,294,696,78,215,216,481,191,229,26,138,164,342,67,16,84,100,857
94,Pat Connaughton,SG,23,POR,34,0,143,13,49,5,21,8,28,5,5,11,21,32,10,2,0,10,6,36
95,Chris Copeland,PF,31,MIL,24,1,156,17,51,10,36,7,15,6,7,1,9,10,11,2,0,6,17,50
96,Bryce Cotton,PG,23,TOT,8,0,39,4,10,0,3,4,7,0,0,0,0,0,3,3,0,5,2,8
96,Bryce Cotton,PG,23,PHO,3,0,33,2,8,0,3,2,5,0,0,0,0,0,3,3,0,5,2,4
96,Bryce Cotton,PG,23,MEM,5,0,6,2,2,0,0,2,2,0,0,0,0,0,0,0,0,0,0,4
97,DeMarcus Cousins,C,25,SAC,65,65,2246,601,1332,70,210,531,1122,476,663,158,589,747,214,101,92,249,236,1748
98,Robert Covington,SF,25,PHI,67,49,1903,274,712,170,482,104,230,140,177,65,354,419,97,105,40,143,232,858
99,Allen Crabbe,SG,23,POR,81,8,2105,311,678,112,285,199,393,98,113,27,189,216,99,63,16,64,192,832
100,Jamal Crawford,SG,35,LAC,79,5,2126,379,939,117,344,262,595,245,271,20,125,145,183,52,12,113,122,1120
101,Jae Crowder,SF,25,BOS,73,73,2308,360,813,122,363,238,450,196,239,70,303,373,135,126,35,83,198,1038
102,Dante Cunningham,SF,28,NOP,80,46,1971,186,412,55,174,131,238,57,82,57,179,236,77,42,33,41,173,484
103,Jared Cunningham,SG,24,TOT,44,3,410,36,105,12,39,24,66,36,55,3,35,38,20,14,2,21,41,120
103,Jared Cunningham,SG,24,CLE,40,3,355,32,91,10,32,22,59,30,48,3,26,29,19,12,2,18,37,104
103,Jared Cunningham,SG,24,MIL,4,0,55,4,14,2,7,2,7,6,7,0,9,9,1,2,0,3,4,16
104,Seth Curry,PG,25,SAC,44,9,692,102,224,50,111,52,113,45,54,9,51,60,67,22,3,36,41,299
105,Stephen Curry,PG,27,GSW,79,79,2700,805,1598,402,886,403,712,363,400,68,362,430,527,169,15,262,161,2375
106,Troy Daniels,SG,24,CHO,43,0,476,89,187,59,122,30,65,5,9,7,50,57,21,11,3,24,40,242
107,Anthony Davis,C,22,NOP,61,61,2164,560,1136,35,108,525,1028,326,430,130,497,627,116,78,125,121,148,1481
108,Ed Davis,PF,26,POR,81,0,1684,206,337,0,0,206,337,114,204,224,375,599,88,57,72,64,202,526
109,Branden Dawson,PF,22,LAC,6,0,29,2,5,0,0,2,5,1,1,2,2,4,0,0,1,0,2,5
110,Dewayne Dedmon,C,26,ORL,58,20,705,99,177,0,0,99,177,57,76,67,161,228,13,22,46,32,109,255
111,Bryce Dejean-Jones,SG,23,NOP,14,11,279,28,69,12,32,16,37,11,21,8,40,48,15,10,2,11,17,79
112,Sam Dekker,PF,21,HOU,3,0,6,0,0,0,0,0,0,0,0,0,1,1,0,1,0,0,0,0
113,Matthew Dellavedova,PG,25,CLE,76,14,1867,207,511,98,239,109,272,57,66,33,129,162,337,44,9,116,178,569
114,Luol Deng,PF,30,MIA,74,73,2394,339,745,88,256,251,489,145,192,108,335,443,140,74,29,81,122,911
115,DeMar DeRozan,SG,26,TOR,78,78,2804,614,1377,47,139,567,1238,555,653,64,285,349,315,81,21,175,167,1830
116,Boris Diaw,PF,33,SAS,76,4,1386,202,383,25,69,177,314,56,76,58,175,233,176,26,21,97,102,485
117,Gorgui Dieng,C,26,MIN,82,39,2220,308,579,6,20,302,559,205,248,157,428,585,143,94,96,140,219,827
118,Spencer Dinwiddie,PG,22,DET,12,0,159,19,54,1,10,18,44,19,33,4,13,17,22,3,0,7,20,58
119,Toney Douglas,PG,29,NOP,61,18,1262,183,445,81,203,102,242,84,99,25,118,143,157,70,5,64,131,531
120,Goran Dragic,PG,29,MIA,72,72,2363,417,875,64,205,353,670,120,165,54,223,277,419,71,17,185,188,1018
121,Andre Drummond,C,22,DET,81,81,2666,552,1060,2,6,550,1054,208,586,395,803,1198,67,119,112,155,245,1314
122,Jared Dudley,PF,30,WAS,81,41,2098,233,487,100,238,133,249,72,98,54,232,286,170,75,18,80,190,638
123,Duje Dukan,SF,24,SAC,1,0,24,2,10,2,5,0,5,0,0,2,2,4,1,1,0,0,2,6
124,Tim Duncan,C,39,SAS,61,60,1536,215,441,0,2,215,439,92,131,115,332,447,163,47,78,90,125,522
125,Mike Dunleavy,SF,35,CHI,31,30,703,77,188,39,99,38,89,29,37,8,75,83,39,14,10,26,66,222
126,Kevin Durant,SF,27,OKC,72,72,2578,698,1381,186,481,512,900,447,498,45,544,589,361,69,85,250,137,2029
127,Cleanthony Early,SF,24,NYK,17,2,154,12,40,4,15,8,25,3,4,4,22,26,6,2,3,9,16,31
128,Jarell Eddie,SF,24,WAS,26,0,147,20,65,15,47,5,18,8,8,2,21,23,5,5,1,1,5,63
129,Wayne Ellington,SG,28,BRK,76,41,1615,218,561,96,268,122,293,54,63,20,154,174,83,48,5,45,82,586
130,Monta Ellis,SG,30,IND,81,81,2734,436,1021,87,282,349,739,162,206,42,229,271,383,150,37,203,174,1121
131,James Ennis,SF,25,TOT,22,5,329,54,113,26,58,28,55,25,34,21,21,42,21,16,5,19,28,159
131,James Ennis,SF,25,MIA,3,0,7,0,0,0,0,0,0,0,0,0,0,0,1,0,0,0,1,0
131,James Ennis,SF,25,MEM,10,0,40,4,13,2,8,2,5,6,10,4,3,7,2,4,2,2,1,16
131,James Ennis,SF,25,NOP,9,5,282,50,100,24,50,26,50,19,24,17,18,35,18,12,3,17,26,143
132,Tyler Ennis,PG,21,MIL,46,7,654,84,187,13,39,71,148,25,34,13,62,75,95,25,1,46,64,206
133,Jeremy Evans,SF,28,DAL,30,2,251,26,48,4,16,22,32,15,21,11,43,54,2,6,9,7,19,71
134,Tyreke Evans,SG,26,NOP,25,25,765,136,314,33,85,103,229,74,93,20,109,129,164,32,8,73,66,379
135,Festus Ezeli,C,26,GSW,46,13,770,125,228,0,0,125,228,70,132,91,166,257,32,18,50,38,94,320
136,Kenneth Faried,PF,26,DEN,67,64,1694,349,626,1,2,348,624,136,222,235,346,581,79,32,60,91,169,835
137,Jordan Farmar,PG,29,MEM,12,10,291,42,100,16,45,26,55,10,10,4,21,25,37,15,2,18,22,110
138,Derrick Favors,PF,24,UTA,62,59,1983,418,811,0,4,418,807,180,254,169,334,503,94,74,91,104,150,1016
139,Cristiano Felicio,C,23,CHI,31,4,321,40,72,0,4,40,68,25,35,30,72,102,26,6,13,13,31,105
140,Raymond Felton,PG,31,DAL,80,31,2192,277,682,60,213,217,469,149,176,36,222,258,284,68,15,121,141,763
141,Evan Fournier,SF,23,ORL,79,71,2566,429,929,156,390,273,539,199,238,33,192,225,213,96,2,133,214,1213
142,Randy Foye,SG,32,TOT,81,8,1642,169,482,75,250,94,232,61,74,24,132,156,161,39,29,86,131,474
142,Randy Foye,SG,32,DEN,54,7,1070,117,333,50,169,67,164,39,47,16,89,105,112,26,16,58,83,323
142,Randy Foye,SG,32,OKC,27,1,572,52,149,25,81,27,68,22,27,8,43,51,49,13,13,28,48,151
143,Tim Frazier,PG,25,TOT,51,2,741,96,229,16,48,80,181,53,74,26,84,110,162,33,2,65,73,261
143,Tim Frazier,PG,25,POR,35,1,272,20,60,3,17,17,43,8,15,11,28,39,42,10,1,27,31,51
143,Tim Frazier,PG,25,NOP,16,1,469,76,169,13,31,63,138,45,59,15,56,71,120,23,1,38,42,210
144,Jimmer Fredette,SG,26,TOT,6,0,18,2,5,1,2,1,3,4,5,0,0,0,1,1,0,2,2,9
144,Jimmer Fredette,SG,26,NOP,4,0,13,1,4,0,1,1,3,0,0,0,0,0,1,1,0,1,1,2
144,Jimmer Fredette,SG,26,NYK,2,0,5,1,1,1,1,0,0,4,5,0,0,0,0,0,0,1,1,7
145,Channing Frye,PF-C,32,TOT,70,32,1200,152,347,91,235,61,112,30,35,35,199,234,71,29,28,43,127,425
145,Channing Frye,PF,32,ORL,44,29,754,81,186,48,121,33,65,19,21,23,118,141,45,21,20,30,71,229
145,Channing Frye,C,32,CLE,26,3,446,71,161,43,114,28,47,11,14,12,81,93,26,8,8,13,56,196
146,Danilo Gallinari,SF,27,DEN,53,53,1839,287,700,87,239,200,461,375,432,52,229,281,135,42,19,77,87,1036
147,Langston Galloway,PG,24,NYK,82,7,2033,231,588,77,224,154,364,86,114,43,245,288,207,77,22,61,177,625
148,Kevin Garnett,PF,39,MIN,38,38,556,54,115,0,1,54,114,14,21,15,135,150,62,28,10,16,70,122
149,Marc Gasol,C,31,MEM,52,52,1791,328,707,2,3,326,704,203,245,58,304,362,196,50,70,118,141,861
150,Pau Gasol,C,35,CHI,72,72,2291,467,995,24,69,443,926,229,289,155,638,793,294,42,146,164,148,1187
151,Rudy Gay,SF,29,SAC,70,70,2379,466,1007,74,215,392,792,198,254,103,353,456,120,100,51,139,184,1204
152,Alonzo Gee,SF,28,NOP,73,38,1632,132,255,17,60,115,195,44,66,60,185,245,72,63,13,55,169,325
153,Paul George,SF,25,IND,81,81,2819,605,1449,210,566,395,883,454,528,79,484,563,329,152,29,265,230,1874
154,Taj Gibson,PF,30,CHI,73,55,1936,263,500,0,3,263,497,101,146,206,298,504,106,47,77,78,180,627
155,Manu Ginobili,SG,38,SAS,58,0,1134,197,435,70,179,127,256,91,112,26,120,146,177,66,11,99,99,555
156,Rudy Gobert,C,23,UTA,61,60,1932,198,354,0,0,198,354,161,283,208,460,668,91,45,135,114,163,557
157,Drew Gooden,PF,34,WAS,30,0,305,33,103,7,41,26,62,9,14,28,57,85,13,8,11,13,40,82
158,Archie Goodwin,PG,21,PHO,57,13,1114,176,422,23,99,153,323,130,193,27,115,142,118,27,13,100,84,505
159,Aaron Gordon,PF,20,ORL,78,37,1863,274,579,42,142,232,437,129,193,154,353,507,128,59,55,66,153,719
160,Eric Gordon,SG,27,NOP,45,44,1481,231,552,113,294,118,258,111,125,10,89,99,121,43,14,73,98,686
161,Marcin Gortat,C,31,WAS,75,74,2256,433,764,0,1,433,763,146,207,222,519,741,106,47,96,121,193,1012
162,Andrew Goudelock,PG,27,HOU,8,0,50,9,20,1,9,8,11,3,4,1,1,2,4,6,2,7,4,22
163,Jerami Grant,PF,21,PHI,77,52,2066,251,599,35,146,216,453,212,322,99,262,361,135,54,127,110,215,749
164,Jerian Grant,PG,23,NYK,76,6,1265,154,391,22,100,132,291,96,123,23,120,143,177,50,10,87,97,426
165,Danny Green,SG,28,SAS,79,79,2062,211,561,116,349,95,212,34,46,48,255,303,141,79,64,75,141,572
166,Draymond Green,PF,25,GSW,81,81,2808,401,819,100,258,301,561,229,329,134,635,769,598,119,113,259,240,1131
167,Erick Green,PG,24,TOT,9,0,42,5,13,1,5,4,8,2,2,3,3,6,3,1,0,0,4,13
167,Erick Green,PG,24,DEN,3,0,7,0,1,0,1,0,0,0,0,0,1,1,1,0,0,0,0,0
167,Erick Green,PG,24,UTA,6,0,35,5,12,1,4,4,8,2,2,3,2,5,2,1,0,0,4,13
168,Gerald Green,SG,30,MIA,69,14,1557,230,587,84,260,146,327,72,92,25,138,163,56,38,19,46,123,616
169,JaMychal Green,PF,25,MEM,78,15,1446,230,495,15,45,215,450,103,137,139,234,373,67,46,33,83,189,578
170,Jeff Green,SF,29,TOT,80,41,2253,354,824,67,213,287,611,164,220,74,258,332,138,58,40,93,164,939
170,Jeff Green,SF,29,MEM,53,31,1544,240,557,42,136,198,421,124,155,55,186,241,98,40,19,69,102,646
170,Jeff Green,SF,29,LAC,27,10,709,114,267,25,77,89,190,40,65,19,72,91,40,18,21,24,62,293
171,Blake Griffin,PF,26,LAC,35,35,1170,301,603,6,18,295,585,141,194,51,243,294,170,28,17,83,95,749
172,Jorge Gutierrez,PG,27,CHO,12,0,63,6,11,0,2,6,9,10,11,0,7,7,17,3,0,6,3,22
173,P.J. Hairston,SF,23,TOT,66,52,1313,145,408,70,241,75,167,50,64,25,149,174,38,32,11,41,137,410
173,P.J. Hairston,SF,23,CHO,48,43,938,99,276,54,172,45,104,34,42,18,110,128,29,24,7,24,106,286
173,P.J. Hairston,SF,23,MEM,18,9,375,46,132,16,69,30,63,16,22,7,39,46,9,8,4,17,31,124
174,Jordan Hamilton,SF,25,NOP,11,4,304,49,116,13,45,36,71,14,21,12,50,62,25,8,3,17,24,125
175,Tyler Hansbrough,PF,30,CHO,44,0,343,32,71,2,3,30,68,38,65,40,49,89,8,12,7,12,55,104
176,Tim Hardaway,SG,23,ATL,51,1,864,114,265,48,142,66,123,50,56,7,79,86,51,21,7,23,48,326
177,James Harden,SG,26,HOU,82,82,3125,710,1617,236,657,474,960,720,837,63,438,501,612,139,51,374,229,2376
178,Maurice Harkless,SF,22,POR,78,14,1457,195,411,39,140,156,271,69,111,101,179,280,67,49,35,62,124,498
179,Justin Harper,PF,26,DET,5,0,35,4,10,4,9,0,1,1,2,0,1,1,0,1,0,2,3,13
180,Montrezl Harrell,PF,22,HOU,39,1,379,58,90,0,1,58,89,24,46,25,40,65,17,11,11,17,48,140
181,Devin Harris,PG,32,DAL,64,0,1280,167,374,52,158,115,216,101,140,18,120,138,118,60,13,66,124,487
182,Gary Harris,SG,21,DEN,76,76,2439,359,765,105,297,254,468,109,133,54,166,220,147,97,18,98,143,932
183,Joe Harris,SG,24,CLE,5,0,15,1,4,1,4,0,0,0,0,0,3,3,2,0,0,1,1,3
184,Tobias Harris,PF,23,TOT,76,74,2513,417,889,80,239,337,650,202,243,96,414,510,169,65,40,108,153,1116
184,Tobias Harris,PF,23,ORL,49,49,1610,251,541,47,151,204,390,120,153,71,271,342,99,47,28,78,91,669
184,Tobias Harris,PF,23,DET,27,25,903,166,348,33,88,133,260,82,90,25,143,168,70,18,12,30,62,447
185,Aaron Harrison,SG,21,CHO,21,0,93,5,19,3,10,2,9,5,12,4,11,15,2,6,0,4,10,18
186,Udonis Haslem,PF,35,MIA,37,0,260,23,61,1,9,22,52,12,16,10,65,75,14,5,2,5,25,59
187,Spencer Hawes,PF,27,CHO,57,6,1035,124,306,38,102,86,204,54,65,51,193,244,109,22,27,58,111,340
188,Chuck Hayes,C,32,HOU,2,0,24,1,2,0,0,1,2,2,2,0,8,8,2,0,0,3,6,4
189,Gordon Hayward,SF,25,UTA,80,80,2893,521,1202,143,410,378,792,393,477,61,336,397,296,95,27,202,183,1578
190,Gerald Henderson,SG,28,POR,72,0,1431,232,529,48,136,184,393,112,146,30,181,211,75,39,19,68,87,624
191,John Henson,C,25,MIL,57,1,960,164,291,0,1,164,290,69,117,87,134,221,54,18,109,64,131,397
192,Mario Hezonja,SF,20,ORL,79,9,1413,181,418,67,192,114,226,49,54,28,148,176,109,39,17,97,124,478
193,Roy Hibbert,C,29,LAL,81,81,1878,182,411,0,2,182,409,117,145,132,266,398,95,32,110,76,252,481
194,J.J. Hickson,C,27,TOT,35,9,436,80,155,0,1,80,154,46,103,39,93,132,23,15,14,25,47,206
194,J.J. Hickson,C,27,DEN,20,9,305,55,109,0,0,55,109,27,59,22,65,87,16,10,12,16,35,137
194,J.J. Hickson,C,27,WAS,15,0,131,25,46,0,1,25,45,19,44,17,28,45,7,5,2,9,12,69
195,Nene Hilario,PF,33,WAS,57,11,1094,209,384,0,3,209,381,107,185,52,207,259,97,54,26,76,156,525
196,George Hill,PG,29,IND,74,73,2524,326,739,128,314,198,425,114,150,58,240,298,259,83,17,101,149,894
197,Jordan Hill,C,28,IND,73,11,1513,278,549,0,1,278,548,89,125,156,295,451,87,36,37,92,155,645
198,Solomon Hill,SF,24,IND,59,3,866,93,208,24,74,69,134,36,42,39,127,166,57,37,11,33,68,246
199,Darrun Hilliard,SG,22,DET,38,2,383,52,131,19,50,33,81,29,40,5,40,45,27,9,1,19,28,152
200,Kirk Hinrich,PG,35,TOT,46,7,631,49,129,24,62,25,67,15,16,8,62,70,73,15,2,30,64,137
200,Kirk Hinrich,PG,35,CHI,35,7,555,47,118,23,56,24,62,15,16,7,51,58,59,13,1,27,63,132
200,Kirk Hinrich,PG,35,ATL,11,0,76,2,11,1,6,1,5,0,0,1,11,12,14,2,1,3,1,5
201,Jrue Holiday,PG,25,NOP,65,23,1831,410,935,87,259,323,676,182,216,27,168,195,391,88,22,167,148,1089
202,Justin Holiday,SG,26,TOT,53,5,773,88,228,36,105,52,123,27,37,12,78,90,56,32,19,39,61,239
202,Justin Holiday,SG,26,ATL,26,1,263,24,73,10,45,14,28,5,10,4,23,27,11,13,4,13,21,63
202,Justin Holiday,SG,26,CHI,27,4,510,64,155,26,60,38,95,22,27,8,55,63,45,19,15,26,40,176
203,Ryan Hollins,C,31,TOT,37,12,460,49,79,0,0,49,79,26,42,47,51,98,10,6,21,24,62,124
203,Ryan Hollins,C,31,WAS,5,3,48,4,7,0,0,4,7,0,0,7,4,11,0,0,1,3,4,8
203,Ryan Hollins,C,31,MEM,32,9,412,45,72,0,0,45,72,26,42,40,47,87,10,6,20,21,58,116
204,Rondae Hollis-Jefferson,SF,21,BRK,29,17,615,63,138,4,14,59,124,37,52,39,115,154,43,39,16,26,61,167
205,Richaun Holmes,PF,22,PHI,51,1,702,114,222,8,44,106,178,51,74,62,73,135,33,19,40,32,92,287
206,Rodney Hood,SG,23,UTA,79,79,2541,408,972,161,449,247,523,172,200,38,229,267,213,73,16,125,202,1149
207,Al Horford,C,29,ATL,82,82,2631,529,1048,88,256,441,792,103,129,148,448,596,263,68,121,107,163,1249
208,Dwight Howard,C,30,HOU,71,71,2280,372,600,0,6,372,594,232,474,238,597,835,98,69,113,166,219,976
209,Marcelo Huertas,PG,32,LAL,53,0,869,97,230,16,61,81,169,27,29,18,72,90,182,26,7,80,76,237
210,Josh Huestis,PF,24,OKC,5,0,55,5,12,4,6,1,6,0,4,2,8,10,0,1,2,3,3,14
211,Kris Humphries,PF,30,TOT,53,17,835,121,295,34,108,87,187,67,84,57,161,218,36,16,23,38,94,343
211,Kris Humphries,PF,30,WAS,28,14,466,64,158,23,67,41,91,29,31,26,89,115,16,3,14,20,42,180
211,Kris Humphries,PF,30,PHO,4,3,74,10,36,3,10,7,26,6,8,11,21,32,7,3,2,4,8,29
211,Kris Humphries,PF,30,ATL,21,0,295,47,101,8,31,39,70,32,45,20,51,71,13,10,7,14,44,134
212,R.J. Hunter,SG,22,BOS,36,0,315,36,98,19,63,17,35,6,7,2,35,37,13,14,4,11,29,97
213,Serge Ibaka,PF,26,OKC,78,78,2500,416,869,60,184,356,685,91,121,141,392,533,66,38,148,108,211,983
214,Andre Iguodala,SF,32,GSW,65,1,1732,176,368,54,154,122,214,51,83,52,211,263,219,73,19,79,102,457
215,Ersan Ilyasova,PF,28,TOT,74,56,1881,280,661,96,259,184,402,111,154,144,259,403,67,52,33,71,171,767
215,Ersan Ilyasova,PF,28,DET,52,52,1434,216,508,78,215,138,293,79,109,99,183,282,55,38,27,59,120,589
215,Ersan Ilyasova,PF,28,ORL,22,4,447,64,153,18,44,46,109,32,45,45,76,121,12,14,6,12,51,178
216,Joe Ingles,SF,28,UTA,81,2,1241,124,291,81,210,43,81,13,18,19,132,151,96,55,4,65,98,342
217,Damien Inglis,SF,20,MIL,20,1,156,13,37,3,13,10,24,7,8,2,29,31,10,6,3,11,11,36
218,Kyrie Irving,PG,23,CLE,53,53,1667,394,879,84,262,310,617,169,191,44,113,157,249,56,18,124,107,1041
219,Jarrett Jack,PG,32,BRK,32,32,1027,140,358,31,102,109,256,100,112,9,127,136,236,34,7,94,77,411
220,Reggie Jackson,PG,25,DET,79,79,2424,540,1244,118,334,422,910,291,337,58,195,253,492,59,11,223,187,1489
221,LeBron James,SF,31,CLE,76,76,2709,737,1416,87,282,650,1134,359,491,111,454,565,514,104,49,249,143,1920
222,Al Jefferson,C,31,CHO,47,18,1096,245,505,0,0,245,505,72,111,57,244,301,70,30,41,34,117,562
223,Cory Jefferson,PF,25,PHO,8,0,50,9,22,0,1,9,21,4,6,6,10,16,0,0,1,0,8,22
224,Richard Jefferson,SF,35,CLE,74,5,1326,143,312,66,173,77,139,58,87,15,113,128,59,33,14,43,129,410
225,John Jenkins,SG,24,TOT,43,3,480,71,160,16,51,55,109,20,24,8,49,57,35,8,1,27,22,178
225,John Jenkins,SG,24,DAL,21,1,193,29,70,3,19,26,51,8,9,4,18,22,9,3,0,11,11,69
225,John Jenkins,SG,24,PHO,22,2,287,42,90,13,32,29,58,12,15,4,31,35,26,5,1,16,11,109
226,Brandon Jennings,PG,26,TOT,48,7,868,112,304,51,155,61,149,57,78,16,80,96,170,29,7,57,57,332
226,Brandon Jennings,PG,26,DET,23,1,416,53,143,24,77,29,66,27,38,5,41,46,70,11,2,22,24,157
226,Brandon Jennings,PG,26,ORL,25,6,452,59,161,27,78,32,83,30,40,11,39,50,100,18,5,35,33,175
227,Jonas Jerebko,PF,28,BOS,78,0,1176,118,286,43,108,75,178,61,78,77,211,288,62,20,24,52,137,340
228,Amir Johnson,PF,28,BOS,79,76,1800,249,426,10,43,239,383,69,121,178,327,505,138,52,83,94,214,577
229,Chris Johnson,SF,25,UTA,70,2,857,72,194,27,99,45,95,34,42,27,105,132,45,32,20,40,100,205
230,James Johnson,PF,28,TOR,57,32,926,114,240,20,66,94,174,39,68,28,98,126,67,29,33,54,84,287
231,Joe Johnson,SF,34,TOT,81,81,2703,377,859,120,313,257,546,118,142,49,243,292,318,61,4,159,146,992
231,Joe Johnson,SF,34,BRK,57,57,1934,247,608,85,229,162,379,92,108,34,190,224,232,40,2,116,100,671
231,Joe Johnson,SF,34,MIA,24,24,769,130,251,35,84,95,167,26,34,15,53,68,86,21,2,43,46,321
232,Orlando Johnson,SG,26,TOT,7,1,101,9,34,2,10,7,24,6,8,4,11,15,2,3,3,4,9,26
232,Orlando Johnson,SG,26,PHO,2,0,47,5,17,1,5,4,12,5,6,3,6,9,0,2,3,1,5,16
232,Orlando Johnson,SG,26,NOP,5,1,54,4,17,1,5,3,12,1,2,1,5,6,2,1,0,3,4,10
233,Stanley Johnson,SF,19,DET,73,6,1687,225,600,63,205,162,395,80,102,58,248,306,118,55,12,114,178,593
234,Tyler Johnson,SG,23,MIA,36,5,863,118,243,27,71,91,172,51,64,28,81,109,79,24,14,47,66,314
235,Wesley Johnson,SF,28,LAC,80,9,1666,208,515,103,309,105,206,30,46,37,211,248,49,89,56,54,173,549
236,Nikola Jokic,C,20,DEN,80,55,1733,307,600,28,84,279,516,154,190,181,379,560,189,79,50,104,208,796
237,Dahntay Jones,SF,35,CLE,1,0,42,6,14,1,2,5,12,0,0,1,4,5,2,1,2,0,6,13
238,James Jones,SF,35,CLE,48,0,463,58,142,41,104,17,38,21,26,8,42,50,14,11,10,13,50,178
239,Terrence Jones,PF,24,HOU,50,11,1044,166,367,25,79,141,288,77,116,62,149,211,41,23,39,49,86,434
240,Tyus Jones,PG,19,MIN,37,0,573,56,156,16,53,40,103,28,39,7,40,47,108,31,3,33,33,156
241,DeAndre Jordan,C,27,LAC,77,77,2598,357,508,0,1,357,507,266,619,267,792,1059,90,51,177,107,207,980
242,Cory Joseph,SG,24,TOR,80,4,2046,257,585,30,110,227,475,133,174,39,171,210,250,63,20,102,131,677
243,Chris Kaman,C,33,POR,16,2,112,20,43,1,4,19,39,3,3,7,17,24,11,1,1,8,15,44
244,Frank Kaminsky,C,22,CHO,81,3,1708,215,525,68,202,147,323,108,148,69,266,335,98,38,43,58,126,606
245,Enes Kanter,C,23,OKC,82,1,1721,414,719,10,21,404,698,200,251,249,415,664,33,26,33,115,166,1038
246,Sergey Karasev,SF,22,BRK,40,5,399,30,74,11,37,19,37,26,28,8,50,58,35,6,2,22,27,97
247,Sasha Kaun,C,30,CLE,25,0,95,9,17,0,0,9,17,5,11,12,14,26,3,4,5,7,11,23
248,Ryan Kelly,PF,24,LAL,36,0,470,55,149,5,37,50,112,37,54,21,100,121,20,13,10,18,39,152
249,Michael Kidd-Gilchrist,SF,22,CHO,7,7,205,33,61,3,7,30,54,20,29,12,33,45,9,3,3,8,9,89
250,Sean Kilpatrick,SG,26,TOT,31,0,616,123,270,39,114,84,156,60,67,12,44,56,29,12,2,31,37,345
250,Sean Kilpatrick,SG,26,DEN,8,0,82,8,21,4,17,4,4,7,8,2,4,6,3,2,0,4,7,27
250,Sean Kilpatrick,SG,26,BRK,23,0,534,115,249,35,97,80,152,53,59,10,40,50,26,10,2,27,30,318
251,Brandon Knight,SG,24,PHO,52,50,1870,371,895,120,351,251,544,156,183,36,166,202,263,61,20,177,124,1018
252,Kyle Korver,SG,34,ATL,80,80,2401,268,616,158,397,110,219,45,54,14,246,260,164,60,35,98,161,739
253,Kosta Koufos,C,26,SAC,78,14,1482,236,444,0,0,236,444,57,104,169,254,423,33,40,70,48,185,529
254,Jeremy Lamb,SG,23,CHO,66,0,1227,230,510,56,181,174,329,64,88,44,208,252,77,42,30,50,105,580
255,Carl Landry,PF,32,PHI,36,12,569,139,250,6,13,133,237,67,91,49,97,146,32,12,9,22,69,351
256,Shane Larkin,PG,23,BRK,78,17,1751,222,502,39,108,183,394,83,107,28,152,180,342,95,12,146,121,566
257,Joffrey Lauvergne,C,24,DEN,59,15,1041,195,380,13,53,182,327,62,69,77,213,290,56,13,15,54,115,465
258,Zach LaVine,SG,20,MIN,82,33,2294,433,959,123,316,310,643,161,203,27,201,228,251,69,17,155,193,1150
259,Ty Lawson,PG,28,TOT,66,13,1411,139,354,36,108,103,246,59,86,26,94,120,237,53,7,95,87,373
259,Ty Lawson,PG,28,HOU,53,12,1176,111,287,31,94,80,193,56,80,20,69,89,180,43,6,82,71,309
259,Ty Lawson,PG,28,IND,13,1,235,28,67,5,14,23,53,3,6,6,25,31,57,10,1,13,16,64
260,Courtney Lee,SG,30,TOT,79,65,2334,290,639,82,217,208,422,99,118,29,176,205,136,85,28,72,134,761
260,Courtney Lee,SG,30,MEM,51,37,1489,192,419,51,138,141,281,76,92,19,99,118,76,52,16,49,79,511
260,Courtney Lee,SG,30,CHO,28,28,845,98,220,31,79,67,141,23,26,10,77,87,60,33,12,23,55,250
261,David Lee,PF,32,TOT,55,5,903,178,335,0,1,178,334,71,93,101,204,305,84,22,28,66,114,427
261,David Lee,PF,32,BOS,30,4,470,87,192,0,1,87,191,40,51,41,89,130,54,12,13,38,51,214
261,David Lee,PF,32,DAL,25,1,433,91,143,0,0,91,143,31,42,60,115,175,30,10,15,28,63,213
262,Alex Len,C,22,PHO,78,46,1821,264,624,1,7,263,617,174,239,178,416,594,97,38,62,145,230,703
263,Kawhi Leonard,SF,24,SAS,72,72,2380,551,1090,129,291,422,799,292,334,95,398,493,186,128,71,105,133,1523
264,Meyers Leonard,PF,23,POR,61,10,1333,195,435,86,228,109,207,35,46,51,263,314,92,8,18,77,183,511
265,Jon Leuer,PF,26,PHO,67,27,1255,224,466,42,110,182,356,77,101,76,297,373,72,38,30,75,125,567
266,Damian Lillard,PG,25,POR,75,75,2676,618,1474,229,610,389,864,414,464,45,257,302,512,65,28,242,165,1879
267,Jeremy Lin,SG,27,CHO,78,13,2048,300,728,76,226,224,502,238,292,42,211,253,235,58,42,150,165,914
268,Shaun Livingston,PG,30,GSW,78,3,1520,203,379,2,12,201,367,80,93,42,127,169,237,57,27,78,140,488
269,Kevon Looney,PF,19,GSW,5,0,21,4,7,1,2,3,5,0,0,4,6,10,0,0,0,1,2,9
270,Brook Lopez,C,27,BRK,73,73,2457,591,1157,2,14,589,1143,317,403,204,369,573,147,58,124,175,215,1501
271,Robin Lopez,C,27,NYK,82,82,2219,357,662,0,1,357,661,128,161,268,334,602,114,16,129,133,182,842
272,Kevin Love,PF,27,CLE,77,77,2424,409,977,158,439,251,538,258,314,149,613,762,186,58,41,142,159,1234
273,Kyle Lowry,PG,29,TOR,77,77,2851,512,1198,212,547,300,651,398,491,55,310,365,494,158,34,225,211,1634
274,Trey Lyles,PF,20,UTA,80,33,1382,191,436,49,128,142,308,57,82,59,240,299,59,26,18,65,114,488
275,Shelvin Mack,PG,25,TOT,52,27,1058,182,415,39,125,143,290,45,61,13,115,128,187,34,3,95,72,448
275,Shelvin Mack,PG,25,ATL,24,0,179,40,95,4,27,36,68,9,12,2,20,22,38,8,0,14,7,93
275,Shelvin Mack,PG,25,UTA,28,27,879,142,320,35,98,107,222,36,49,11,95,106,149,26,3,81,65,355
276,Ian Mahinmi,C,29,IND,71,71,1816,264,448,0,0,264,448,132,225,138,369,507,104,65,75,100,220,660
277,Devyn Marble,SG,23,ORL,28,0,249,21,71,8,32,13,39,10,24,6,32,38,12,13,1,7,25,60
278,Boban Marjanovic,C,27,SAS,54,4,508,105,174,0,0,105,174,87,114,73,121,194,21,12,23,29,54,297
279,Kendall Marshall,PG,24,PHI,30,6,400,43,118,16,49,27,69,9,13,2,26,28,73,16,2,43,30,111
280,Jarell Martin,PF,21,MEM,27,0,380,54,116,0,2,54,114,45,62,39,47,86,15,8,7,19,58,153
281,Kevin Martin,SG,32,TOT,55,13,1095,156,419,49,136,107,283,153,172,14,96,110,58,26,3,54,83,514
281,Kevin Martin,SG,32,MIN,39,12,834,126,334,38,103,88,231,125,142,10,71,81,46,17,1,41,68,415
281,Kevin Martin,SG,32,SAS,16,1,261,30,85,11,33,19,52,28,30,4,25,29,12,9,2,13,15,99
282,Wesley Matthews,SF,29,DAL,78,78,2644,331,854,189,525,142,329,126,146,27,211,238,151,78,17,78,179,977
283,O.J. Mayo,SG,28,MIL,41,24,1090,119,321,52,162,67,159,31,40,13,92,105,118,48,8,72,126,321
284,Luc Mbah a Moute,PF,29,LAC,75,61,1274,94,207,13,40,81,167,30,57,60,111,171,30,44,19,34,100,231
285,James Michael McAdoo,PF,23,GSW,41,1,262,45,84,1,2,44,82,26,49,30,28,58,17,10,8,16,39,117
286,Ray McCallum,PG,24,TOT,41,6,475,55,146,15,42,40,104,12,15,8,39,47,60,12,7,24,29,137
286,Ray McCallum,PG,24,SAS,31,3,256,27,67,5,16,22,51,9,10,6,25,31,33,5,4,11,14,68
286,Ray McCallum,PG,24,MEM,10,3,219,28,79,10,26,18,53,3,5,2,14,16,27,7,3,13,15,69
287,CJ McCollum,SG,24,POR,80,80,2780,641,1431,197,472,444,959,187,226,47,212,259,341,97,23,196,187,1666
288,T.J. McConnell,PG,23,PHI,81,17,1606,218,464,31,89,187,375,26,41,43,207,250,367,95,10,140,114,493
289,Chris McCullough,PF,20,BRK,24,4,362,44,109,13,34,31,75,11,23,25,43,68,9,28,12,15,39,112
290,K.J. McDaniels,SF,22,HOU,37,1,235,29,72,7,25,22,47,24,30,16,26,42,10,7,6,17,30,89
291,Doug McDermott,SF,24,CHI,81,4,1861,291,644,110,259,181,385,72,84,37,158,195,59,14,6,53,127,764
292,Mitch McGary,PF,23,OKC,20,0,72,11,23,0,4,11,19,4,10,4,14,18,3,1,2,7,10,26
293,JaVale McGee,C,28,DAL,34,2,370,77,134,0,1,77,133,18,36,53,80,133,3,5,26,21,49,172
294,Ben McLemore,SG,22,SAC,68,53,1443,195,455,67,185,128,270,74,103,34,114,148,79,52,10,99,140,531
295,Jordan McRae,PG,24,TOT,22,1,195,34,78,10,22,24,56,21,28,4,16,20,25,3,1,15,17,99
295,Jordan McRae,PG,24,PHO,7,0,82,11,26,3,11,8,15,12,15,2,6,8,10,3,0,6,7,37
295,Jordan McRae,PG,24,CLE,15,1,113,23,52,7,11,16,41,9,13,2,10,12,15,0,1,9,10,62
296,Josh McRoberts,PF,28,MIA,42,1,595,55,148,12,49,43,99,28,40,22,83,105,81,18,7,30,68,150
297,Jodie Meeks,SG,28,DET,3,0,43,7,20,4,9,3,11,4,4,1,4,5,3,0,0,1,2,22
298,Salah Mejri,C,29,DAL,34,6,397,49,78,0,1,49,77,27,46,41,82,123,10,8,36,23,54,125
299,Jordan Mickey,PF,21,BOS,16,0,57,8,22,0,0,8,22,5,10,6,7,13,1,0,11,1,5,21
300,Khris Middleton,SG,24,MIL,79,79,2852,507,1142,143,361,364,781,277,312,44,258,302,331,131,19,180,204,1434
301,C.J. Miles,SF,28,IND,64,24,1464,259,634,142,387,117,247,93,124,25,150,175,63,53,29,70,142,753
302,Andre Miller,PG,39,TOT,39,4,461,59,106,2,8,57,98,24,32,12,39,51,87,16,0,37,46,144
302,Andre Miller,PG,39,MIN,26,0,280,36,58,1,4,35,54,15,19,6,18,24,58,9,0,25,32,88
302,Andre Miller,PG,39,SAS,13,4,181,23,48,1,4,22,44,9,13,6,21,27,29,7,0,12,14,56
303,Mike Miller,SF,35,DEN,47,2,373,22,62,19,52,3,10,0,0,6,47,53,40,13,4,17,53,63
304,Patty Mills,PG,27,SAS,81,3,1662,260,612,123,320,137,292,47,58,27,131,158,226,59,6,76,102,690
305,Elijah Millsap,SG,28,UTA,20,0,173,11,39,1,12,10,27,13,18,6,29,35,19,7,3,9,33,36
306,Paul Millsap,PF,30,ATL,81,81,2647,501,1066,74,232,427,834,309,408,198,534,732,265,147,139,191,237,1385
307,Nikola Mirotic,PF,24,CHI,66,38,1646,248,609,135,346,113,263,146,181,58,304,362,100,58,46,102,151,777
308,Nazr Mohammed,C,38,OKC,5,0,19,3,5,0,0,3,5,2,2,1,3,4,0,0,0,3,4,8
309,Greg Monroe,C,25,MIL,79,67,2314,491,941,0,1,491,940,228,308,218,478,696,178,72,67,129,163,1210
310,Luis Montero,SG,22,POR,12,0,42,5,19,1,9,4,10,3,4,0,4,4,1,0,0,4,1,14
311,E'Twaun Moore,SG,26,CHI,59,22,1263,187,389,47,104,140,285,22,35,19,114,133,99,37,18,53,103,443
312,Eric Moreland,PF,24,SAC,8,0,48,3,6,0,0,3,6,2,4,3,8,11,1,0,4,3,4,8
313,Marcus Morris,SF,26,DET,80,80,2856,410,945,108,298,302,647,203,271,91,313,404,201,67,23,140,170,1131
314,Markieff Morris,PF,26,TOT,64,45,1629,305,718,47,155,258,563,108,147,73,279,352,124,58,34,135,184,765
314,Markieff Morris,PF,26,PHO,37,24,917,171,431,22,76,149,355,66,92,43,151,194,87,33,17,90,104,430
314,Markieff Morris,PF,26,WAS,27,21,712,134,287,25,79,109,208,42,55,30,128,158,37,25,17,45,80,335
315,Anthony Morrow,SG,30,OKC,68,6,926,136,333,79,204,57,129,29,39,10,52,62,24,22,5,17,64,380
316,Donatas Motiejunas,PF,25,HOU,37,22,547,90,205,16,57,74,148,34,53,37,72,109,41,17,5,44,69,230
317,Timofey Mozgov,C,29,CLE,76,48,1326,203,359,1,7,202,352,68,95,110,227,337,33,22,57,71,159,475
318,Emmanuel Mudiay,PG,19,DEN,68,66,2068,329,905,74,232,255,673,140,209,32,200,232,372,65,35,217,141,872
319,Shabazz Muhammad,SF,23,MIN,82,0,1682,317,681,44,152,273,529,185,242,100,167,267,52,24,7,70,94,863
320,Xavier Munford,SG,23,MEM,14,0,244,32,77,9,23,23,54,7,14,3,28,31,22,13,3,15,25,80
321,Mike Muscala,C,24,ATL,60,0,565,76,152,12,39,64,113,31,39,38,79,117,34,13,27,27,72,195
322,Larry Nance,PF,23,LAL,63,22,1266,158,300,1,10,157,290,32,47,101,211,312,44,54,23,41,124,349
323,Shabazz Napier,PG,24,ORL,55,0,600,68,201,34,104,34,97,33,45,9,46,55,97,23,1,46,38,203
324,Gary Neal,SG,31,WAS,40,2,807,151,325,41,100,110,225,47,55,11,72,83,47,20,1,29,55,390
325,Jameer Nelson,PG,33,DEN,39,15,1036,113,307,43,144,70,163,30,35,19,96,115,190,25,5,66,100,299
326,Raul Neto,PG,23,UTA,81,53,1499,180,418,64,162,116,256,52,70,17,103,120,174,62,2,109,122,476
327,Andrew Nicholson,PF,26,ORL,56,0,823,146,310,41,114,105,196,51,65,34,167,201,25,10,22,41,69,384
328,Joakim Noah,C,30,CHI,29,2,635,51,133,0,1,51,132,22,45,87,168,255,110,18,29,52,77,124
329,Nerlens Noel,C,21,PHI,67,62,1965,306,587,1,2,305,585,134,227,154,388,542,122,118,100,158,192,747
330,Lucas Nogueira,C,23,TOR,29,1,225,28,44,1,3,27,41,8,15,18,28,46,7,12,12,11,29,65
331,Steve Novak,PF,32,TOT,10,0,44,8,18,7,15,1,3,1,1,0,5,5,0,0,0,1,3,24
331,Steve Novak,PF,32,OKC,7,0,24,6,12,5,9,1,3,0,0,0,4,4,0,0,0,1,1,17
331,Steve Novak,PF,32,MIL,3,0,20,2,6,2,6,0,0,1,1,0,1,1,0,0,0,0,2,7
332,Dirk Nowitzki,PF,37,DAL,75,75,2364,498,1112,126,342,372,770,250,280,52,437,489,132,52,52,84,161,1372
333,Jusuf Nurkic,C,21,DEN,32,3,547,101,242,0,3,101,239,61,99,65,110,175,40,24,44,55,91,263
334,J.J. O'Brien,SF,23,UTA,2,0,6,0,1,0,0,0,1,0,0,0,1,1,0,1,0,0,1,0
335,Johnny O'Bryant,PF,22,MIL,66,4,857,86,209,1,1,85,208,27,40,65,111,176,32,18,8,31,100,200
336,Kyle O'Quinn,PF,25,NYK,65,1,764,129,271,5,22,124,249,46,60,76,174,250,72,20,49,61,107,309
337,Jahlil Okafor,C,20,PHI,53,48,1591,397,781,1,6,396,775,133,194,122,251,373,65,22,61,124,140,928
338,Victor Oladipo,SG,23,ORL,72,52,2379,425,970,98,282,327,688,205,247,48,297,345,282,116,54,153,174,1153
339,Kelly Olynyk,C,24,BOS,69,8,1395,253,556,85,210,168,346,96,128,72,209,281,105,52,33,74,163,687
340,Kelly Oubre,SF,20,WAS,63,9,671,90,211,25,79,65,132,31,49,25,108,133,13,22,7,34,100,236
341,Zaza Pachulia,C,31,DAL,76,69,2004,219,470,0,3,219,467,212,276,249,469,718,128,64,22,119,181,650
342,Kostas Papanikolaou,SF,25,DEN,26,6,294,24,66,10,32,14,34,9,14,8,32,40,16,13,5,21,24,67
343,Jabari Parker,PF,20,MIL,76,72,2408,443,899,9,35,434,864,175,228,123,272,395,130,69,29,116,154,1070
344,Tony Parker,PG,33,SAS,72,72,1980,350,710,27,65,323,645,130,171,17,159,176,379,54,11,131,114,857
345,Chandler Parsons,SF,27,DAL,61,51,1799,320,651,104,251,216,400,93,136,29,256,285,169,46,21,95,114,837
346,Lamar Patterson,SG,24,ATL,35,0,395,28,80,12,49,16,31,16,22,4,46,50,39,9,2,23,45,84
347,Patrick Patterson,PF,26,TOR,79,0,2020,204,493,106,293,98,200,29,34,77,265,342,94,53,32,65,128,543
348,Chris Paul,PG,30,LAC,74,74,2420,515,1114,122,329,393,785,294,328,39,271,310,738,152,13,194,185,1446
349,Adreian Payne,PF,24,MIN,52,2,486,53,145,9,32,44,113,17,26,20,91,111,29,16,11,36,77,132
350,Cameron Payne,PG,21,OKC,57,1,698,114,278,36,111,78,167,19,24,9,76,85,108,36,6,44,80,283
351,Elfrid Payton,PG,21,ORL,73,69,2145,318,730,30,92,288,638,112,190,77,184,261,468,89,20,177,159,778
352,Nikola Pekovic,C,30,MIN,12,3,156,19,50,0,0,19,50,16,20,7,14,21,11,1,0,9,22,54
353,Kendrick Perkins,C,31,NOP,37,5,542,40,75,0,0,40,75,11,25,25,103,128,31,11,11,41,64,91
354,Paul Pierce,SF,38,LAC,68,38,1231,144,397,75,242,69,155,54,66,12,174,186,71,33,17,58,129,417
355,Tibor Pleiss,C,26,UTA,12,0,82,11,25,0,2,11,23,2,2,6,9,15,2,1,2,8,19,24
356,Mason Plumlee,C,25,POR,82,82,2084,267,517,0,4,267,513,215,335,201,427,628,226,68,85,154,253,749
357,Miles Plumlee,C,27,MIL,61,14,870,140,233,0,0,140,233,34,59,94,138,232,16,21,50,40,73,314
358,Otto Porter,SF,22,WAS,75,73,2276,339,717,98,267,241,450,95,126,97,294,391,120,105,32,70,163,871
359,Bobby Portis,PF,20,CHI,62,4,1102,186,436,16,52,170,384,48,66,123,214,337,52,25,22,54,100,436
360,Kristaps Porzingis,PF,20,NYK,72,72,2047,373,886,81,243,292,643,201,240,132,394,526,94,53,134,121,205,1028
361,Dwight Powell,PF,24,DAL,69,2,992,146,296,2,16,144,280,105,142,84,189,273,44,36,24,40,118,399
362,Norman Powell,SG,22,TOR,49,24,725,97,229,36,89,61,140,43,53,16,95,111,47,29,10,32,59,273
363,Phil Pressey,PG,24,TOT,23,0,283,30,78,4,18,26,60,13,25,3,28,31,75,18,4,33,28,77
363,Phil Pressey,PG,24,PHI,14,0,170,21,55,4,13,17,42,9,18,0,23,23,46,11,1,19,14,55
363,Phil Pressey,PG,24,PHO,9,0,113,9,23,0,5,9,18,4,7,3,5,8,29,7,3,14,14,22
364,Ronnie Price,PG,32,PHO,62,18,1211,116,302,68,196,48,106,31,41,25,74,99,147,74,13,70,161,331
365,Pablo Prigioni,PG,38,LAC,59,3,823,55,147,28,95,27,52,7,8,38,76,114,130,53,1,49,82,145
366,Tayshaun Prince,SF,35,MIN,77,44,1462,102,229,4,23,98,206,13,19,32,115,147,73,36,13,27,62,221
367,Julius Randle,PF,21,LAL,81,60,2286,358,835,10,36,348,799,193,270,172,657,829,144,53,29,149,242,919
368,Zach Randolph,PF,34,MEM,68,53,2016,431,907,6,26,425,881,172,216,179,350,529,142,43,13,105,146,1040
369,J.J. Redick,SG,31,LAC,75,75,2097,422,880,200,421,222,459,182,205,10,129,139,106,42,5,78,135,1226
370,Willie Reed,C,25,BRK,39,2,426,76,133,0,0,76,133,30,55,49,73,122,10,6,30,16,47,182
371,Josh Richardson,SG,22,MIA,52,2,1107,123,272,53,115,70,157,42,63,21,86,107,73,36,25,35,107,341
372,Austin Rivers,SG,23,LAC,67,7,1464,226,516,62,185,164,331,79,116,22,108,130,99,48,9,61,137,593
373,Andre Roberson,SG,24,OKC,70,70,1553,136,274,32,103,104,171,33,54,79,172,251,47,53,42,35,133,337
374,Brian Roberts,PG,30,TOT,51,0,470,74,165,15,42,59,123,42,47,6,35,41,54,10,2,23,35,205
374,Brian Roberts,PG,30,CHO,30,0,333,51,115,9,27,42,88,34,37,4,25,29,38,7,1,16,23,145
374,Brian Roberts,PG,30,POR,21,0,137,23,50,6,15,17,35,8,10,2,10,12,16,3,1,7,12,60
375,Glenn Robinson,SF,22,IND,45,4,508,65,151,14,37,51,114,27,39,12,56,68,26,17,9,18,21,171
376,Nate Robinson,PG,31,NOP,2,1,23,0,1,0,1,0,0,0,0,0,0,0,4,1,0,0,5,0
377,Thomas Robinson,PF,24,BRK,71,7,917,130,291,0,1,130,290,47,109,136,223,359,46,39,36,69,111,307
378,Rajon Rondo,PG,29,SAC,72,72,2537,355,782,62,170,293,612,87,150,77,358,435,839,141,10,278,175,859
379,Derrick Rose,PG,27,CHI,66,66,2097,447,1048,44,150,403,898,142,179,46,179,225,311,44,14,175,84,1080
380,Terrence Ross,SF,24,TOR,73,7,1747,270,626,131,339,139,287,49,62,21,164,185,56,54,25,46,120,720
381,Terry Rozier,PG,21,BOS,39,0,311,29,106,6,27,23,79,8,10,24,39,63,37,6,1,19,23,72
382,Ricky Rubio,PG,25,MIN,76,76,2323,219,586,62,190,157,396,266,314,40,286,326,658,162,10,193,201,766
383,Damjan Rudez,SF,29,MIN,33,0,277,25,62,17,50,8,12,8,8,5,15,20,11,3,1,13,33,75
384,Brandon Rush,SG,30,GSW,72,25,1055,111,260,65,157,46,103,18,28,21,160,181,57,20,23,33,57,305
385,D'Angelo Russell,PG,19,LAL,80,48,2259,392,956,130,370,262,586,140,190,47,227,274,266,93,13,196,142,1054
386,Robert Sacre,C,26,LAL,25,1,320,31,75,0,0,31,75,25,38,32,40,72,14,4,10,12,43,87
387,JaKarr Sampson,SF,22,TOT,73,40,1160,140,317,14,63,126,254,80,122,46,144,190,46,23,33,70,142,374
387,JaKarr Sampson,SF,22,PHI,47,18,691,86,202,6,34,80,168,62,97,30,99,129,30,11,16,51,91,240
387,JaKarr Sampson,SF,22,DEN,26,22,469,54,115,8,29,46,86,18,25,16,45,61,16,12,17,19,51,134
388,Dennis Schroder,PG,22,ATL,80,6,1621,329,781,77,239,252,542,144,182,25,179,204,349,70,9,183,138,879
389,Luis Scola,PF,35,TOR,76,76,1636,269,598,65,161,204,437,61,84,84,276,360,66,46,27,68,178,664
390,Mike Scott,PF,27,ATL,75,0,1146,176,376,62,158,114,218,50,63,53,153,206,78,25,17,42,102,464
391,Thabo Sefolosha,SF,31,ATL,75,11,1758,188,372,42,124,146,248,62,99,52,282,334,107,85,37,68,109,480
392,Kevin Seraphin,C,26,NYK,48,0,526,84,205,0,2,84,203,19,23,31,95,126,47,8,36,43,67,187
393,Ramon Sessions,PG,29,WAS,82,5,1667,280,592,36,111,244,481,214,283,25,178,203,239,46,5,115,102,810
394,Iman Shumpert,SG,25,CLE,54,5,1316,114,305,43,146,71,159,40,51,32,171,203,92,54,19,57,119,311
395,Jonathon Simmons,SG,26,SAS,55,2,813,122,242,18,47,104,195,69,92,16,80,96,58,24,5,53,103,331
396,Henry Sims,C,25,BRK,14,4,263,33,77,0,0,33,77,25,30,21,51,72,9,9,14,12,37,91
397,Kyle Singler,SF,27,OKC,68,2,977,86,221,30,97,56,124,29,44,50,91,141,24,30,9,32,120,231
398,Donald Sloan,PG,28,BRK,61,33,1318,154,350,38,99,116,251,78,104,17,156,173,268,32,4,80,73,424
399,Marcus Smart,PG,21,BOS,61,10,1667,184,529,61,241,123,288,129,166,76,179,255,185,91,18,80,183,558
400,Greg Smith,PF,25,MIN,18,0,192,18,32,0,0,18,32,7,17,12,30,42,6,4,1,7,28,43
401,Ish Smith,PG,27,TOT,77,53,2239,397,967,56,170,341,797,122,176,43,262,305,502,88,24,175,133,972
401,Ish Smith,PG,27,NOP,27,3,617,98,228,10,33,88,195,33,43,14,78,92,154,24,6,45,38,239
401,Ish Smith,PG,27,PHI,50,50,1622,299,739,46,137,253,602,89,133,29,184,213,348,64,18,130,95,733
402,J.R. Smith,SG,30,CLE,77,77,2362,353,850,204,510,149,340,45,71,43,174,217,130,81,21,59,204,955
403,Jason Smith,C,29,ORL,76,2,1181,244,503,4,16,240,487,54,67,53,166,219,62,33,65,57,163,546
404,Josh Smith,PF,30,TOT,55,7,880,127,349,41,143,86,206,37,67,51,141,192,90,34,47,77,118,332
404,Josh Smith,PF,30,LAC,32,1,459,69,180,18,58,51,122,25,42,33,92,125,42,18,34,41,62,181
404,Josh Smith,PF,30,HOU,23,6,421,58,169,23,85,35,84,12,25,18,49,67,48,16,13,36,56,151
405,Russ Smith,PG,24,MEM,15,0,66,7,22,1,5,6,17,8,13,1,8,9,11,5,1,7,5,23
406,Tony Snell,SF,24,CHI,64,33,1301,126,339,56,155,70,184,30,33,19,180,199,63,16,17,52,100,338
407,Marreese Speights,C,28,GSW,72,0,832,197,456,24,62,173,394,94,114,77,162,239,61,19,34,66,117,512
408,Tiago Splitter,C,31,ATL,36,2,579,81,155,0,2,81,153,39,48,45,75,120,30,20,12,24,71,201
409,Nik Stauskas,SG,22,PHI,73,35,1809,210,545,106,325,104,220,91,118,23,160,183,138,44,20,94,115,617
410,Lance Stephenson,SF,25,TOT,69,13,1372,228,474,30,78,198,396,87,111,40,183,223,133,43,9,94,135,573
410,Lance Stephenson,SF,25,LAC,43,10,680,82,166,19,47,63,119,21,30,19,89,108,60,24,3,48,79,204
410,Lance Stephenson,SF,25,MEM,26,3,692,146,308,11,31,135,277,66,81,21,94,115,73,19,6,46,56,369
411,Alex Stepheson,PF,28,TOT,8,0,73,9,27,0,0,9,27,4,12,19,9,28,2,1,5,0,12,22
411,Alex Stepheson,PF,28,LAC,4,0,12,1,1,0,0,1,1,0,2,1,1,2,0,0,2,0,4,2
411,Alex Stepheson,PF,28,MEM,4,0,61,8,26,0,0,8,26,4,10,18,8,26,2,1,3,0,8,20
412,Jarnell Stokes,C,22,TOT,7,0,18,3,5,0,0,3,5,1,2,1,3,4,1,1,0,0,1,7
412,Jarnell Stokes,C,22,MEM,2,0,4,0,0,0,0,0,0,0,0,1,1,2,0,0,0,0,0,0
412,Jarnell Stokes,C,22,MIA,5,0,14,3,5,0,0,3,5,1,2,0,2,2,1,1,0,0,1,7
413,Amar'e Stoudemire,C,33,MIA,52,36,762,125,221,0,0,125,221,50,67,65,157,222,27,18,41,47,92,300
414,Rodney Stuckey,PG,29,IND,58,1,1275,183,443,20,83,163,360,131,158,19,137,156,142,43,8,76,77,517
415,Jared Sullinger,PF,23,BOS,81,73,1915,351,806,29,103,322,703,103,161,194,479,673,187,75,47,102,209,834
416,Edy Tavares,C,23,ATL,11,0,73,11,19,0,0,11,19,3,8,7,14,21,3,1,6,5,8,25
417,Jeff Teague,PG,27,ATL,79,78,2255,434,988,110,275,324,713,261,312,33,181,214,470,97,24,218,167,1239
418,Mirza Teletovic,PF,30,PHO,79,1,1686,332,777,181,460,151,317,120,155,55,247,302,89,32,21,84,159,965
419,Garrett Temple,SF,29,WAS,80,43,1951,201,505,89,258,112,247,91,125,36,176,212,140,69,18,64,195,582
420,Jason Terry,SG,38,HOU,72,7,1258,151,376,93,261,58,115,27,33,14,65,79,103,47,9,49,91,422
421,Isaiah Thomas,PG,26,BOS,82,79,2644,591,1382,167,465,424,917,474,544,46,197,243,509,91,9,220,167,1823
422,Lance Thomas,PF,27,NYK,59,5,1313,169,382,44,109,125,273,102,119,34,97,131,53,22,7,57,109,484
423,Hollis Thompson,SG,24,PHI,77,17,2154,270,680,149,392,121,288,69,96,54,218,272,99,36,24,76,187,758
424,Jason Thompson,C,29,TOT,47,7,471,52,108,5,15,47,93,38,54,32,102,134,29,12,20,15,80,147
424,Jason Thompson,C,29,GSW,28,1,179,20,42,0,0,20,42,20,32,10,44,54,19,4,8,7,40,60
424,Jason Thompson,C,29,TOR,19,6,292,32,66,5,15,27,51,18,22,22,58,80,10,8,12,8,40,87
425,Klay Thompson,SG,25,GSW,80,80,2666,651,1386,276,650,375,736,193,221,35,271,306,166,60,49,138,152,1771
426,Tristan Thompson,PF,24,CLE,82,34,2269,247,420,0,0,247,420,149,242,268,470,738,62,38,51,61,202,643
427,Marcus Thornton,SG,28,TOT,61,8,1109,216,542,91,270,125,272,67,79,38,112,150,85,47,4,51,90,590
427,Marcus Thornton,SG,28,HOU,47,6,885,174,435,73,216,101,219,51,58,31,84,115,66,34,3,40,73,472
427,Marcus Thornton,SG,28,WAS,14,2,224,42,107,18,54,24,53,16,21,7,28,35,19,13,1,11,17,118
428,Anthony Tolliver,PF,30,DET,72,5,1341,128,332,98,272,30,60,29,47,39,190,229,52,26,16,28,86,383
429,Axel Toupane,SF,23,DEN,21,0,305,25,70,13,40,12,30,13,17,8,23,31,15,7,6,6,40,76
430,Karl-Anthony Towns,C,20,MIN,82,82,2627,625,1153,30,88,595,1065,223,275,229,629,858,161,58,138,183,245,1503
431,P.J. Tucker,SF,30,PHO,82,80,2540,239,582,68,206,171,376,106,142,165,347,512,177,106,20,111,202,652
432,Evan Turner,SG,27,BOS,81,12,2271,343,753,20,83,323,670,148,179,50,347,397,359,80,28,169,139,854
433,Myles Turner,C,19,IND,60,30,1367,264,530,3,14,261,516,88,121,68,264,332,41,25,86,67,158,619
434,Beno Udrih,PG,33,TOT,44,5,707,86,198,15,44,71,154,18,20,8,64,72,116,14,1,53,51,205
434,Beno Udrih,PG,33,MEM,8,0,120,20,46,4,11,16,35,3,3,2,7,9,26,3,1,11,11,47
434,Beno Udrih,PG,33,MIA,36,5,587,66,152,11,33,55,119,15,17,6,57,63,90,11,0,42,40,158
435,Jonas Valanciunas,C,23,TOR,60,59,1557,303,536,0,0,303,536,162,213,184,363,547,42,25,80,85,158,768
436,Anderson Varejao,C,33,TOT,53,0,496,53,124,0,1,53,123,32,50,37,104,141,35,16,10,22,70,138
436,Anderson Varejao,C,33,CLE,31,0,310,32,76,0,1,32,75,16,21,24,67,91,20,11,5,16,35,80
436,Anderson Varejao,C,33,GSW,22,0,186,21,48,0,0,21,48,16,29,13,37,50,15,5,5,6,35,58
437,Greivis Vasquez,PG,29,MIL,23,0,460,45,138,18,73,27,65,22,26,5,42,47,91,10,0,40,42,130
438,Rashad Vaughn,SG,19,MIL,70,6,1001,81,266,43,147,38,119,12,15,11,77,88,39,29,16,28,73,217
439,Charlie Villanueva,PF,31,DAL,62,4,665,125,327,47,172,78,155,22,24,24,128,152,24,18,15,31,71,319
440,Noah Vonleh,PF,20,POR,78,56,1174,117,278,11,46,106,232,38,51,91,214,305,30,27,26,50,152,283
441,Nikola Vucevic,C,25,ORL,65,60,2037,533,1046,2,9,531,1037,113,150,174,402,576,179,53,70,123,173,1181
442,Sasha Vujacic,SG,31,NYK,61,25,908,106,277,52,143,54,134,32,39,26,123,149,84,34,5,44,83,296
443,Dwyane Wade,SG,34,MIA,74,73,2258,540,1183,7,44,533,1139,322,406,82,220,302,344,79,42,203,116,1409
444,Dion Waiters,SG,24,OKC,78,15,2152,282,706,86,240,196,466,112,157,36,166,202,154,81,15,120,143,762
445,Kemba Walker,PG,25,CHO,81,81,2885,568,1331,182,490,386,841,371,438,56,301,357,421,126,39,171,111,1689
446,John Wall,PG,25,WAS,77,77,2784,572,1349,115,328,457,1021,272,344,42,337,379,789,145,59,318,159,1531
447,T.J. Warren,SF,22,PHO,47,4,1070,221,441,28,70,193,371,45,64,57,90,147,44,37,16,32,94,515
448,C.J. Watson,PG,31,ORL,33,2,656,47,137,14,48,33,89,34,39,10,56,66,88,19,5,25,49,142
449,Briante Weber,PG,23,TOT,7,4,169,14,39,0,5,14,34,3,4,8,17,25,21,9,3,9,12,31
449,Briante Weber,PG,23,MEM,6,4,166,13,38,0,5,13,33,3,4,8,16,24,20,9,3,9,11,29
449,Briante Weber,PG,23,MIA,1,0,3,1,1,0,0,1,1,0,0,0,1,1,1,0,0,0,1,2
450,Sonny Weems,SG-SF,29,TOT,43,0,499,42,110,15,41,27,69,8,15,7,46,53,49,10,1,41,47,107
450,Sonny Weems,SG,29,PHO,36,0,421,35,89,13,32,22,57,7,13,6,35,41,47,10,1,37,40,90
450,Sonny Weems,SF,29,PHI,7,0,78,7,21,2,9,5,12,1,2,1,11,12,2,0,0,4,7,17
451,David West,PF,35,SAS,78,19,1404,244,448,3,7,241,441,63,80,72,237,309,143,44,55,68,142,554
452,Russell Westbrook,PG,27,OKC,80,80,2750,656,1444,101,341,555,1103,465,573,145,481,626,834,163,20,342,200,1878
453,Hassan Whiteside,C,26,MIA,73,43,2125,413,682,0,0,413,682,214,329,238,627,865,30,44,269,137,201,1040
454,Shayne Whittington,PF,24,IND,7,0,41,5,11,0,2,5,9,1,2,5,7,12,3,1,1,5,7,11
455,Andrew Wiggins,SF,20,MIN,81,81,2845,594,1294,57,190,537,1104,430,565,105,186,291,164,78,46,182,165,1675
456,C.J. Wilcox,SG,25,LAC,23,0,167,26,66,9,23,17,43,9,12,1,11,12,10,10,2,2,15,70
457,Alan Williams,PF,23,PHO,10,0,68,10,24,0,0,10,24,9,14,14,24,38,5,4,5,6,15,29
458,Deron Williams,PG,31,DAL,65,63,2106,321,775,97,282,224,493,179,206,19,171,190,378,61,14,150,155,918
459,Derrick Williams,SF,24,NYK,80,9,1435,254,565,44,150,210,415,194,256,47,249,296,75,29,9,61,69,746
460,Elliot Williams,PG,26,MEM,5,0,45,2,10,1,4,1,6,3,4,1,3,4,4,0,0,1,2,8
461,Lou Williams,SG,29,LAL,67,35,1907,283,693,110,320,173,373,352,424,31,138,169,167,62,19,107,107,1028
462,Marvin Williams,PF,29,CHO,81,81,2338,338,747,152,378,186,369,120,144,127,394,521,110,58,77,62,133,948
463,Mo Williams,PG,33,CLE,41,14,748,132,302,36,102,96,200,38,42,6,66,72,98,14,5,57,60,338
464,Justise Winslow,SF,19,MIA,78,8,2232,195,462,32,116,163,346,80,117,81,322,403,117,68,26,95,184,502
465,Jeff Withey,C,25,UTA,51,10,658,87,162,0,2,87,160,43,59,56,117,173,20,21,53,28,75,217
466,Christian Wood,PF,20,PHI,17,0,145,22,53,4,11,18,42,13,21,13,25,38,3,5,7,2,11,61
467,Metta World Peace,SF,36,LAL,35,5,590,55,177,26,84,29,93,40,57,19,70,89,27,22,11,15,67,176
468,Brandan Wright,PF,28,MEM,12,2,212,35,52,0,0,35,52,13,24,14,29,43,6,5,15,10,21,83
469,Delon Wright,PG,23,TOR,27,1,229,36,80,5,13,31,67,26,35,8,29,37,31,8,3,16,7,103
470,Tony Wroten,PG,22,PHI,8,3,144,22,65,3,17,19,48,20,37,2,19,21,20,3,0,29,11,67
471,James Young,SG,20,BOS,29,0,199,11,36,6,26,5,10,1,4,4,22,26,9,6,1,5,17,29
472,Joe Young,PG,23,IND,41,0,384,62,169,10,46,52,123,20,25,6,44,50,65,15,0,33,30,154
473,Nick Young,SG,30,LAL,54,2,1033,126,372,77,237,49,135,63,76,14,83,97,34,23,7,30,50,392
474,Thaddeus Young,PF,27,BRK,73,73,2407,495,963,7,30,488,933,105,163,176,484,660,135,112,37,136,182,1102
475,Cody Zeller,C,23,CHO,73,60,1774,231,437,1,10,230,427,175,232,138,317,455,71,57,63,68,204,638
476,Tyler Zeller,C,26,BOS,60,3,710,138,290,0,0,138,290,88,108,62,116,178,29,10,22,46,97,364
